49
18
44 21 21 21 21 21 21 21 21 21 21 21 21 21 21 21 21 21 21 21 21 21 21 21 21 21 21 21 21 21 21 21 21 21 21 21 21 21 21 21 21 21 21 21 21 21 21 21 44 
44 21 21 21 21 21 21 21 21 21 21 21 21 21 21 21 21 21 21 21 21 21 21 21 21 21 21 21 21 21 21 21 21 21 21 21 21 21 21 21 21 21 21 21 21 21 21 21 44 
44 21 21 21 21 21 21 21 21 21 21 21 21 21 21 21 21 21 21 21 21 21 21 21 21 21 21 21 21 21 21 21 21 21 21 21 21 21 21 21 21 21 21 21 21 21 21 21 44 
44 21 21 21 21 21 21 21 21 21 21 21 21 21 21 21 21 21 21 21 21 21 21 21 21 21 21 21 21 21 21 21 21 21 21 21 21 21 21 21 21 21 21 21 21 21 21 21 44 
44 21 21 21 21 21 21 21 21 21 21 21 21 21 21 21 21 21 21 21 21 21 21 21 21 21 21 21 21 21 21 21 21 21 21 21 21 21 21 21 21 21 21 21 21 21 21 21 44 
44 21 21 21 21 21 21 21 21 21 21 21 21 21 21 21 21 21 21 21 21 21 21 21 21 21 21 21 21 21 21 21 21 21 21 21 21 21 21 21 21 21 21 21 21 21 21 21 44 
44 21 21 21 21 21 21 21 21 21 21 21 21 21 21 21 21 21 21 21 21 21 21 21 21 21 21 21 21 21 21 21 21 21 21 21 21 21 21 21 21 21 21 21 21 21 21 21 44 
44 21 21 21 21 21 21 21 21 21 21 21 21 21 21 21 21 21 21 21 21 21 21 21 21 21 21 21 21 21 21 21 21 21 21 21 21 21 21 21 21 21 21 21 21 21 21 21 44 
44 21 21 21 21 21 21 21 21 21 21 21 21 21 21 21 21 21 21 21 21 21 21 21 21 21 21 21 21 21 21 21 21 21 21 21 21 21 21 21 21 21 21 21 21 21 21 21 44 
42 41 41 30 21 21 21 21 21 21 21 29 41 41 30 21 21 21 21 21 21 21 29 41 41 30 21 21 21 21 21 21 21 29 41 41 30 21 21 21 21 21 21 21 29 41 41 41 43 
44 44 44 33 21 21 21 21 21 21 21 32 44 44 33 21 21 21 21 21 21 21 32 44 44 33 21 21 21 21 21 21 21 32 44 44 33 21 21 21 21 21 21 21 32 44 44 44 44 
44 31 31 21 21 21 21 21 21 21 21 21 31 31 21 21 21 21 21 21 21 21 21 31 31 21 21 21 21 21 21 21 21 21 31 31 21 21 21 21 21 21 21 21 32 44 44 44 44 
44 21 21 21 21 21 21 21 21 21 21 21 21 21 21 21 21 21 21 21 21 21 21 21 21 21 21 21 21 21 21 21 21 21 21 21 21 21 21 21 21 21 21 21 32 44 44 44 44 
44 21 21 21 21 21 21 21 21 21 21 21 21 21 21 21 21 21 21 21 21 21 21 21 21 21 21 21 21 21 21 21 21 21 21 21 21 21 21 21 21 21 21 21 32 44 44 44 44 
42 41 41 41 30 21 29 41 30 21 29 41 41 41 41 30 21 29 41 30 21 29 41 41 41 41 30 21 29 41 30 21 29 41 41 41 41 30 21 29 41 30 21 29 41 43 44 44 44 
44 31 31 31 21 21 21 31 21 21 21 31 31 31 31 21 21 21 31 21 21 21 31 31 31 31 21 21 21 31 21 21 21 31 31 31 31 21 21 21 31 21 21 21 31 31 31 31 31 
44 21 21 21 21 21 21 21 21 21 21 21 21 21 21 21 21 21 21 21 21 21 21 21 21 21 21 21 21 21 21 21 21 21 21 21 21 21 21 21 21 21 21 21 21 21 21 21 21 
44 21 21 21 21 21 21 21 21 21 21 21 21 21 21 21 21 21 21 21 21 21 21 21 21 21 21 21 21 21 21 21 21 21 21 21 21 21 21 21 21 21 21 21 21 21 21 21 21
