20
18
23 23 23 23 23 23 23 23 23 23 23 23 23 23 23 23 23 23 23 23 
23 20 18 18 18 18 18 18 18 18 18 18 18 18 18 18 18 18 19 23 
23 5 0 0 0 0 0 0 0 0 0 0 0 0 0 0 0 0 4 23 
23 5 0 0 0 0 0 0 0 0 0 0 0 0 0 0 0 0 4 23 
23 5 0 2 22 22 22 22 22 22 22 22 22 22 22 22 3 0 4 23 
23 5 0 4 23 23 23 23 23 23 23 23 23 23 23 23 5 0 4 23 
23 5 0 4 23 23 23 23 23 15 16 23 23 23 23 23 5 0 4 23 
23 5 0 4 23 23 23 23 23 23 23 23 23 23 23 23 5 0 4 23 
23 5 0 4 23 23 23 23 23 23 23 23 23 23 23 23 5 0 4 23 
6 22 22 22 7 23 23 23 23 23 23 23 23 23 23 6 22 22 22 7 
23 20 18 18 18 18 18 18 18 18 18 18 18 18 19 23 20 18 19 23 
23 5 0 0 0 0 0 0 0 0 0 0 0 0 0 18 0 0 4 23 
23 5 0 0 0 0 0 0 0 0 0 0 0 0 0 0 0 0 4 23 
23 5 0 0 0 0 0 0 0 0 0 0 0 0 0 0 0 0 4 23 
6 22 22 22 22 22 22 22 22 22 22 22 22 22 22 22 22 22 22 7
0 0 0 0 0 0 0 0 0 0 0 0 0 0 0 0 0 0 0 0 
0 0 0 0 0 0 0 0 0 0 0 0 0 0 0 0 0 0 0 0 
0 0 0 0 0 0 0 0 0 0 0 0 0 0 0 0 0 0 0 0