20
33
23 23 23 23 23 23 23 23 23 23 23 23 23 23 23 23 23 23 23 23 
23 20 18 18 18 18 18 18 18 18 18 18 18 18 18 18 18 18 19 23 
23 5 0 0 0 0 0 0 0 0 0 0 0 0 0 0 0 0 4 23 
23 5 0 0 0 0 0 0 0 0 0 0 0 0 0 0 0 0 4 23 
23 5 0 0 0 0 0 0 0 0 0 0 0 0 0 0 0 0 4 23 
23 5 0 0 0 0 0 0 0 0 0 0 0 0 0 0 0 0 4 23 
23 5 0 0 0 0 0 0 0 0 0 0 0 0 0 0 0 12 4 23 
23 5 0 0 0 0 0 0 0 12 0 0 0 0 0 2 22 22 22 7 
23 5 0 0 0 0 0 0 24 25 26 0 2 22 3 4 23 23 23 23 
23 5 0 0 0 0 0 0 0 0 0 0 0 18 0 0 18 18 19 23 
23 5 0 0 24 26 0 0 0 0 0 0 0 0 0 0 0 0 4 23 
23 5 0 0 0 0 0 0 0 0 0 0 0 0 0 0 0 0 4 23 
23 5 0 12 0 0 0 0 0 0 0 0 0 0 0 0 0 0 4 23 
23 5 2 22 3 0 0 0 0 0 0 0 0 0 0 0 0 0 4 23 
23 5 4 6 22 3 0 0 0 0 0 0 0 0 0 0 0 0 4 23 
23 5 0 18 18 0 0 0 12 0 0 0 0 0 0 0 0 0 4 23 
23 5 0 0 0 0 0 24 26 0 0 0 0 0 0 0 0 0 4 23 
23 5 0 0 0 0 0 0 0 0 0 11 0 0 0 0 0 0 4 23 
23 5 0 0 0 0 0 0 0 0 0 24 26 0 0 0 0 0 4 23 
23 5 0 0 0 0 0 0 0 0 0 0 0 0 0 0 0 0 4 23 
23 5 0 0 0 0 0 0 0 0 0 0 0 0 0 12 10 0 4 23 
23 5 0 0 0 0 0 0 0 0 0 0 0 0 0 24 26 0 4 23 
23 5 0 0 0 0 0 0 0 0 0 0 0 0 0 0 0 0 4 23 
23 5 0 0 0 0 0 0 12 11 0 12 0 0 0 0 0 0 4 23 
23 5 0 0 0 0 0 0 24 25 25 25 26 0 0 0 0 0 4 23 
23 5 0 0 0 10 0 0 0 0 0 0 0 0 0 12 0 0 4 23 
23 5 0 0 24 25 26 0 0 0 0 0 0 0 24 25 26 0 4 23 
23 5 0 0 0 0 0 0 0 0 0 0 0 0 0 0 0 0 4 23 
23 5 0 0 12 10 0 0 0 11 0 10 0 0 0 10 0 0 11 23 
6 22 22 22 22 22 22 22 22 22 22 22 22 22 22 22 22 22 22 7
6 22 22 22 22 22 22 22 22 22 22 22 22 22 22 22 22 22 22 7
6 22 22 22 22 22 22 22 22 22 22 22 22 22 22 22 22 22 22 7
6 22 22 22 22 22 22 22 22 22 22 22 22 22 22 22 22 22 22 7

