20
33
37 37 37 37 37 37 37 37 37 37 37 37 37 37 37 37 37 37 37 37 
37 20 18 18 18 18 18 18 18 18 18 18 18 18 18 18 18 18 19 37 
37 5 0 0 0 0 0 0 0 0 0 0 0 0 0 0 0 0 4 37 
37 5 0 0 0 0 0 0 0 0 0 0 0 0 0 0 0 0 4 37 
37 5 0 0 0 0 0 0 0 0 0 0 0 0 0 0 0 0 4 37 
37 5 0 0 0 0 0 0 0 0 0 0 0 0 0 0 0 0 4 37 
37 5 0 0 0 0 0 0 0 0 0 0 0 0 0 0 0 0 4 37 
37 5 0 0 0 0 0 0 0 0 0 0 0 0 0 0 0 0 4 37 
37 5 0 0 0 0 0 0 0 0 0 0 0 0 0 0 0 0 4 37 
6 36 36 36 36 36 36 3 0 0 0 0 0 0 0 0 0 0 4 37 
37 37 37 37 37 37 37 5 0 0 0 0 0 0 0 0 0 0 4 37 
37 37 37 37 37 37 37 5 0 0 0 0 0 0 0 0 0 0 4 37 
37 37 37 37 37 37 6 36 36 36 3 0 0 0 0 0 0 0 4 37 
37 37 37 37 37 37 37 37 37 37 5 0 0 0 0 0 0 0 4 37 
37 37 37 37 37 37 37 37 37 37 5 0 0 0 0 0 0 0 4 37 
37 37 37 37 37 37 37 37 37 6 36 36 36 28 21 21 21 21 32 44 
44 17 22 22 22 22 22 22 22 22 22 22 22 21 21 29 41 30 32 44 
44 33 21 21 21 21 21 21 21 21 21 21 21 21 21 21 31 21 32 44 
44 33 21 21 21 21 21 21 21 21 21 21 21 21 29 41 30 21 32 44 
44 33 21 21 21 21 21 29 41 41 30 21 21 21 21 31 21 21 32 44 
44 33 21 21 21 21 21 21 31 31 21 29 41 41 30 21 21 21 32 44 
44 33 21 29 41 41 30 21 21 21 21 21 31 31 21 21 21 21 32 44 
44 33 21 21 31 31 21 21 21 21 21 21 21 21 21 21 21 21 32 44 
44 33 21 21 21 21 29 41 41 30 21 21 21 21 21 21 21 21 32 44 
44 33 21 21 21 21 21 31 31 21 21 21 21 21 21 21 21 21 32 44 
44 33 21 21 21 21 21 21 21 21 21 21 21 21 21 21 21 21 32 44 
42 41 41 41 41 41 41 41 41 41 41 41 41 30 21 21 21 21 32 44 
44 44 44 44 44 44 44 44 44 44 44 44 44 33 21 21 21 21 32 44 
44 44 44 44 44 44 44 44 44 44 44 44 44 33 21 21 21 21 32 44 
44 44 44 44 44 44 44 44 44 44 44 44 42 41 41 41 41 41 41 43 
0 0 0 0 0 0 0 0 0 0 0 0 0 0 0 0 0 0 0 0 
0 0 0 0 0 0 0 0 0 0 0 0 0 0 0 0 0 0 0 0 
0 0 0 0 0 0 0 0 0 0 0 0 0 0 0 0 0 0 0 0
