20
18
23 5 0 0 0 0 0 0 0 0 0 0 0 0 0 0 0 0 4 23 
23 5 0 0 0 0 0 0 0 0 0 0 0 0 0 0 0 0 4 23 
23 5 0 0 0 0 0 0 0 0 0 0 0 0 0 0 0 0 4 23 
23 5 0 0 0 0 0 0 0 0 0 0 0 0 0 0 0 0 4 23 
23 5 0 0 0 0 0 0 0 0 0 0 0 0 0 0 0 0 4 23 
23 5 0 0 0 0 0 0 0 0 0 0 0 0 0 0 0 0 4 23 
23 5 0 0 0 0 0 0 0 0 0 0 0 0 0 0 0 0 4 23 
23 5 0 0 0 0 0 0 0 0 0 0 0 0 0 0 0 0 4 23 
23 5 0 0 0 0 0 0 0 0 0 0 0 0 0 0 0 0 4 23 
23 5 0 0 0 0 0 0 0 0 0 0 0 0 0 0 0 0 4 23 
23 5 0 0 0 0 0 0 0 0 0 0 0 0 0 0 0 0 4 23 
23 5 0 0 0 0 0 0 0 0 0 0 0 0 0 0 0 0 4 23 
23 5 0 0 0 0 0 0 0 0 0 0 0 0 0 0 0 0 4 23 
23 5 0 0 0 0 0 0 0 0 0 0 0 0 0 0 0 0 4 23 
6 22 22 22 22 22 22 3 0 0 0 0 0 0 2 22 22 22 22 7 
0 0 0 0 0 0 0 0 0 0 0 0 0 0 0 0 0 0 0 0 
0 0 0 0 0 0 0 0 0 0 0 0 0 0 0 0 0 0 0 0 
0 0 0 0 0 0 0 0 0 0 0 0 0 0 0 0 0 0 0 0



