20
20
37 37 37 37 37 37 37 37 37 37 37 37 37 37 37 37 37 37 37 37 
37 20 18 18 18 18 18 18 19 37 20 18 18 18 18 18 18 19 37 37 
37 5 0 0 0 0 0 0 4 37 5 0 0 0 0 0 0 4 37 37 
37 5 0 0 0 0 0 0 4 37 5 0 0 0 0 0 0 4 37 37 
6 36 3 0 2 36 36 36 36 8 36 36 36 36 3 0 0 4 37 37 
37 37 5 0 4 37 37 37 37 37 37 37 37 37 5 0 0 4 37 37 
37 6 36 3 0 18 19 37 37 37 37 37 37 20 0 2 36 36 7  37 
37 37 37 5 0 0 4 37 37 37 37 37 20 0 0 4 37 37 37 37 
37 37 6 36 3 0 4 37 20 18 18 18 0 0 2 36 7 37 37 37 
37 37 37 6 36 3 4 37 5 0 0 0 0 2 36 7 37 37 37 37 
37 37 37 37 37 5 0 18 0 0 0 0 0 4 37 37 37 37 37 37 
37 37 37 37 37 5 0 0 0 0 0 0 0 4 37 37 37 37 37 37 
37 37 37 37 37 5 0 0 0 0 0 0 0 4 37 37 37 37 37 37 
37 37 37 37 37 5 0 0 0 0 0 0 0 4 37 37 37 37 37 37 
37 37 37 37 37 5 0 0 0 0 0 0 0 4 37 37 37 37 37 37 
37 37 37 37 37 5 0 0 0 0 0 0 0 4 37 37 37 37 37 37 
37 37 37 37 6 36 36 36 36 36 36 36 36 36 7 37 37 37 37 37 
0 0 0 0 0 0 0 0 0 0 0 4 0 0 0 0 0 0 0  0 
0 0 0 0 0 0 0 0 0 0 0 4 0 0 0 0 0 0 0  0 
0 0 0 0 0 0 0 0 0 0 0 4 0 0 0 0 0 0 0  0 
