20
18
37 37 37 37 37 37 37 37 37 37 37 37 37 37 37 37 37 37 37 37 
37 20 18 19 37 37 37 37 37 37 37 37 37 37 37 37 37 37 37 37 
37 5 0 4 37 37 37 37 37 37 37 37 37 37 37 37 37 37 37 37 
37 5 0 4 37 37 37 37 37 37 37 37 37 37 37 37 37 37 37 37 
6 36 36 36 7 37 37 37 20 18 18 19 37 37 37 37 37 37 37 37 
37 37 37 37 37 37 37 37 5 0 0 4 37 37 37 37 37 37 37 37 
37 20 18 18 18 18 18 18 0 0 0 0 18 18 18 18 18 18 19 37 
37 5 0 0 0 0 0 0 0 0 0 0 0 0 0 0 0 0 4 37 
37 5 0 0 0 0 0 0 2 36 36 3 0 0 0 0 0 0 4 37 
6 36 36 36 36 36 36 36 36 7 6 36 36 36 36 36 36 36 36 7 
37 37 37 37 37 37 37 37 37 37 37 37 37 37 37 37 37 37 37 37 
37 37 37 37 37 37 37 37 37 37 37 37 37 37 37 37 37 37 37 37 
37 37 37 37 37 37 37 37 37 37 37 37 37 37 37 37 37 37 37 37 
37 37 37 37 37 37 37 37 37 37 37 37 37 37 37 37 37 37 37 37 
37 37 37 37 37 37 37 37 37 37 37 37 37 37 37 37 37 37 37 37 
0 0 0 0 0 0 0 0 0 0 0 0 0 0 0 0 37 0 0 0 
0 0 0 0 0 0 0 0 0 0 0 0 0 0 0 0 37 0 0 0 
0 0 0 0 0 0 0 0 0 0 0 0 0 0 0 0 37 0 0 0