20
21
22 22 22 22 22 22 22 22 22 22 22 22 22 22 22 22 22 22 22 22 
22 1 1 1 1 1 1 1 1 22 22 1 1 1 1 1 1 1 1 22 
22 1 1 1 1 1 1 1 1 22 22 1 1 1 1 1 1 1 1 22 
22 1 1 1 1 1 1 1 1 22 22 1 1 1 1 1 1 1 1 22 
22 1 1 1 1 1 1 1 1 22 22 1 1 1 1 1 1 1 1 22 
22 1 1 1 1 1 1 1 1 22 22 1 1 1 1 1 1 1 1 22 
22 1 1 1 1 1 1 1 1 22 22 1 1 1 1 1 1 1 1 22 
22 1 1 1 1 1 1 1 1 22 22 1 1 1 1 1 1 1 1 22 
22 1 1 1 1 1 1 1 1 22 22 1 1 1 1 1 1 1 1 22 
22 1 1 1 1 1 1 1 1 22 22 23 23 23 23 1 1 1 1 22 
22 1 1 1 1 1 1 1 1 22 22 22 22 22 22 1 1 1 1 22 
22 1 1 1 1 1 1 1 1 22 22 22 22 22 22 1 1 1 1 22 
22 1 1 1 1 1 1 1 1 22 22 22 22 22 22 1 1 1 1 22 
22 1 1 1 1 1 1 1 1 22 22 22 22 22 22 1 1 1 1 22 
22 1 1 1 1 1 1 1 1 22 22 22 22 22 22 1 1 1 1 22 
22 1 1 1 1 23 23 23 23 22 22 22 22 22 22 1 1 1 1 22 
22 1 1 1 1 22 22 22 22 22 22 22 22 22 22 1 1 1 1 22 
22 23 23 23 23 22 22 22 22 22 22 22 22 22 22 23 23 23 23 22
0 0 0 0 0 0 0 0 0 0 0 0 0 0 0 0 0 0 0 0 
0 0 0 0 0 0 0 0 0 0 0 0 0 0 0 0 0 0 0 0 
0 0 0 0 0 0 0 0 0 0 0 0 0 0 0 0 0 0 0 0 
