20
28
22 22 22 22 22 22 22 22 22 22 22 22 22 22 22 22 22 22 22 22 
22 2 2 2 2 2 2 2 2 2 2 2 2 2 2 2 2 2 2 22 
22 1 1 1 1 1 1 1 1 1 1 1 1 1 1 1 1 1 1 22 
22 1 1 1 1 1 1 1 1 1 1 1 1 1 1 1 1 1 1 22 
22 1 1 1 1 1 1 1 1 1 1 1 1 1 1 1 1 1 1 22 
22 1 1 1 1 1 1 1 1 1 1 1 1 1 1 1 1 1 1 22 
22 1 1 1 1 1 1 1 1 1 1 1 1 1 1 1 1 1 1 22 
22 1 1 1 1 1 1 1 1 1 1 1 1 1 1 1 1 1 1 22 
22 1 1 1 1 1 1 1 1 1 1 1 1 1 1 1 1 1 1 22 
22 1 1 1 1 1 1 1 1 1 1 1 1 1 1 1 1 1 1 22 
22 1 1 1 1 1 1 1 1 1 1 1 1 1 1 1 1 1 1 22 
22 1 1 1 1 1 1 1 1 1 1 1 1 1 23 23 23 23 23 23 
22 1 1 1 1 1 1 1 1 1 1 1 1 1 22 22 22 22 22 22 
22 1 1 1 1 1 1 1 1 1 1 1 1 1 22 22 22 22 22 22 
22 1 1 1 1 1 1 1 1 1 1 1 1 1 22 22 22 22 22 22 
22 1 1 1 1 1 1 1 1 1 1 1 1 1 22 22 22 22 22 22 
22 1 1 1 1 1 1 1 1 1 1 1 1 1 22 22 22 22 22 22 
22 1 1 1 1 1 1 1 1 1 1 1 1 1 22 22 22 22 22 22 
22 1 1 1 1 1 1 1 1 1 1 1 1 1 22 22 22 22 22 22 
22 1 1 1 1 1 1 1 1 1 1 1 1 1 22 22 22 22 22 22 
22 1 1 1 1 1 1 1 1 1 1 1 1 1 22 22 22 22 22 22 
22 1 1 1 1 1 1 1 1 1 1 1 1 1 22 22 22 22 22 22 
22 1 1 1 1 1 1 1 1 1 1 1 1 1 22 22 22 22 22 22 
22 1 1 1 1 1 1 1 1 1 1 1 1 1 22 22 22 22 22 22 
22 23 23 23 23 23 23 23 23 23 23 23 23 23 22 22 22 22 22 22 
0 0 0 0 0 0 0 0 0 0 0 0 0 0 0 0 0 0 0 0 
0 0 0 0 0 0 0 0 0 0 0 0 0 0 0 0 0 0 0 0 
0 0 0 0 0 0 0 0 0 0 0 0 0 0 0 0 0 0 0 0
