20
24
44 33 21 21 21 21 21 21 32 44 44 33 21 21 21 21 21 21 32 44 
44 33 21 21 21 21 21 21 32 44 44 33 21 21 21 21 21 21 32 44 
44 33 21 21 21 21 21 21 32 44 44 33 21 21 21 21 21 21 32 44 
44 33 21 21 21 21 21 21 32 44 44 33 21 21 21 21 21 21 32 44 
44 33 21 21 21 21 21 21 32 44 44 33 21 21 21 21 21 21 32 44 
44 33 21 21 21 29 41 41 41 43 42 41 41 41 30 21 21 21 32 44 
44 33 21 21 21 21 31 31 31 31 31 31 31 31 21 21 21 21 32 44 
44 33 21 21 21 21 21 21 29 41 41 30 21 21 21 21 21 21 32 44 
44 33 21 21 21 21 21 21 32 44 44 33 21 21 21 21 21 21 32 44 
44 33 21 21 21 21 21 21 32 44 44 33 21 21 21 21 21 21 32 44 
44 33 29 41 41 41 41 30 32 44 44 33 29 41 41 41 41 30 32 44 
44 33 21 31 31 31 31 21 32 44 44 33 21 31 31 31 31 21 32 44 
44 33 21 21 21 21 21 21 32 44 44 33 21 21 21 21 21 21 32 44 
44 33 21 21 21 21 21 21 32 44 44 33 21 21 21 21 21 21 32 44 
44 33 21 21 29 41 41 41 41 43 42 41 41 41 41 30 21 21 32 44 
44 33 21 21 32 44 44 44 44 44 44 44 44 44 44 33 21 21 32 44 
44 33 21 21 32 44 44 44 44 44 44 44 44 44 44 33 21 21 32 44 
44 33 21 21 21 31 31 31 31 31 31 31 31 31 31 21 21 21 32 44 
44 33 21 21 21 21 21 21 21 21 21 21 21 21 21 21 21 21 32 44 
44 33 21 21 21 21 21 21 21 21 21 21 21 21 21 21 21 21 32 44 
42 41 41 41 41 41 41 41 41 41 41 41 41 41 41 41 41 41 41 43 
44 0 0 0 0 0 0 0 0 0 0 0 0 0 0 0 0 0 0 0 
44 0 0 0 0 0 0 0 0 0 0 0 0 0 0 0 0 0 0 0 
44 0 0 0 0 0 0 0 0 0 0 0 0 0 0 0 0 0 0 0 