44
51
44 33 21 21 21 21 21 21 21 21 21 21 21 21 21 21 21 21 21 21 21 21 21 21 21 21 21 21 21 32 44 44 44 44 44 44 44 44 44 44 44 33 32 44 
44 33 21 21 21 21 21 21 21 21 21 21 21 21 21 21 21 21 21 21 21 21 21 21 21 21 21 21 21 32 44 44 44 44 44 44 44 44 44 44 44 33 32 44 
44 33 21 21 21 21 21 21 21 21 21 21 21 21 21 21 21 21 21 21 21 21 21 21 21 21 21 21 21 32 44 44 44 44 44 44 44 44 44 44 44 33 32 44 
44 33 21 21 21 21 21 21 21 21 21 21 21 21 21 21 21 21 21 21 21 21 21 21 21 21 21 21 21 32 44 44 44 44 44 44 44 44 44 44 44 33 32 44 
44 33 21 21 21 21 21 21 21 21 21 21 21 21 21 21 21 21 21 21 21 21 21 21 21 21 21 21 21 32 44 44 44 44 44 44 44 44 44 44 44 33 32 44 
44 33 21 21 21 21 21 21 21 21 21 21 21 21 21 21 21 21 21 21 21 21 21 21 29 41 41 41 41 41 43 44 44 44 44 44 44 44 44 44 44 33 32 44 
44 33 21 21 21 21 21 21 21 21 21 21 21 21 21 21 21 21 21 21 21 21 21 21 32 44 44 44 44 44 44 44 44 44 44 44 44 44 44 44 44 33 32 44 
44 33 21 21 21 21 21 21 21 21 21 21 21 21 21 21 21 21 21 21 21 21 21 21 21 31 31 31 31 31 31 31 31 31 31 31 31 31 31 31 31 21 32 44 
44 33 21 21 21 21 21 21 21 21 21 21 21 21 21 21 21 21 21 21 21 21 21 21 21 21 21 21 21 21 21 21 21 21 21 21 21 21 21 21 21 21 32 44 
44 33 21 21 21 21 21 21 21 21 21 21 21 21 21 21 21 21 21 21 21 21 21 21 21 21 21 21 21 21 21 21 21 21 21 21 21 21 21 21 21 21 32 44 
44 33 21 21 21 21 21 21 21 21 21 21 21 21 21 21 21 21 29 41 41 41 41 41 41 30 21 21 21 21 21 21 21 21 21 21 21 21 21 21 21 21 32 44 
44 33 21 21 21 21 21 21 21 21 21 21 21 21 21 21 21 21 32 44 44 44 44 44 44 33 21 21 21 21 21 21 21 21 21 21 21 21 21 21 21 21 32 44 
44 33 21 21 21 21 21 21 21 29 41 41 41 30 21 29 41 30 32 44 44 44 44 44 44 33 29 41 30 21 21 21 21 21 21 21 21 21 21 21 21 21 32 44 
44 33 21 21 21 21 21 21 21 21 31 31 31 21 21 21 31 21 32 44 44 44 44 44 44 33 21 31 21 21 21 21 21 21 21 21 21 21 21 21 21 21 32 44 
44 33 21 21 21 29 41 30 21 21 21 21 21 21 21 21 21 21 32 44 44 44 44 44 44 33 21 21 29 41 30 21 21 21 21 21 21 21 21 21 21 21 32 44 
44 33 21 21 21 21 31 21 21 21 21 21 21 21 21 21 21 21 32 44 44 44 44 44 44 33 21 21 21 31 21 21 21 21 21 21 21 21 21 21 21 21 32 44 
44 33 21 21 21 29 41 41 30 21 21 21 21 21 21 21 21 21 32 44 44 44 44 44 44 33 21 21 21 21 21 29 41 30 21 21 21 21 21 21 21 21 32 44 
44 33 21 21 21 21 31 31 21 21 21 21 21 21 21 21 21 21 32 44 44 44 44 44 44 33 21 21 21 21 21 21 31 21 21 21 21 21 21 21 21 21 32 44 
44 33 21 21 21 21 21 21 21 29 41 30 21 21 21 21 21 21 32 44 44 44 44 44 44 33 21 21 21 21 21 21 21 21 29 41 41 30 21 21 21 21 32 44 
44 33 21 21 21 21 21 21 21 21 31 21 21 21 21 21 21 21 32 44 44 44 44 44 44 33 21 21 21 21 21 21 21 21 21 31 31 21 21 21 21 21 32 44 
44 33 21 21 21 21 21 21 21 21 21 21 29 41 30 21 21 21 32 44 44 44 44 44 44 33 21 21 21 21 21 21 21 21 21 21 21 21 29 41 30 21 32 44 
44 33 21 21 21 21 21 21 21 21 21 21 32 44 21 21 21 21 32 44 44 44 44 44 44 33 21 21 21 21 21 21 21 21 21 21 21 21 21 31 21 21 32 44 
44 33 21 21 21 21 21 21 21 21 21 29 41 43 21 21 21 21 32 44 44 44 44 44 44 33 21 21 21 21 21 21 21 21 21 21 29 41 30 21 21 21 32 44 
44 33 21 21 21 21 21 21 21 21 21 21 31 31 21 21 21 21 32 44 44 44 44 44 44 33 21 21 21 21 21 21 21 21 21 21 21 31 21 21 21 21 32 44 
44 33 21 21 21 29 41 30 21 29 41 30 21 21 21 21 21 21 32 44 44 44 44 44 44 33 29 41 30 21 21 29 41 41 30 21 21 21 21 21 21 21 32 44 
44 33 21 21 21 21 31 21 21 21 31 21 21 21 21 21 21 21 32 44 44 44 44 44 44 33 21 31 21 21 21 21 31 31 21 21 21 21 21 21 21 21 32 44 
44 33 29 41 30 21 21 21 21 21 21 21 21 21 21 21 21 21 32 44 44 44 44 44 44 33 21 21 21 21 21 21 21 21 21 21 21 21 21 21 21 21 32 44 
44 33 32 44 21 21 21 21 21 21 21 21 21 21 21 21 21 21 32 44 44 44 44 44 44 33 29 41 41 30 21 21 21 21 21 21 21 21 21 21 21 21 32 44 
44 33 32 42 41 30 21 21 21 21 21 21 21 21 21 21 21 21 32 44 44 44 44 44 44 33 21 31 31 21 21 21 21 21 21 21 21 21 21 21 21 21 32 44 
44 33 21 31 31 21 21 21 21 21 21 21 21 21 21 21 21 21 32 44 44 44 44 44 44 33 21 21 21 21 29 41 30 21 21 21 21 21 21 21 21 21 32 44 
44 33 21 21 21 21 21 29 41 30 21 21 21 21 21 21 21 21 32 44 44 44 44 44 44 33 21 21 21 21 21 31 21 21 21 21 21 21 21 21 21 21 32 44 
44 33 21 21 21 21 21 21 31 21 21 21 21 21 21 21 21 21 32 44 44 44 44 44 44 33 21 21 21 21 21 21 21 21 29 41 30 21 21 21 21 21 32 44 
44 33 21 21 29 41 30 21 21 21 21 21 21 21 21 21 21 21 32 44 44 44 44 44 44 33 21 21 21 21 21 21 21 21 21 31 21 21 21 21 21 21 32 44 
44 33 21 21 21 31 21 21 21 21 21 21 21 21 21 21 21 21 32 44 44 44 44 44 44 33 21 21 21 21 21 21 21 21 21 21 21 21 29 41 41 30 32 44 
44 33 21 21 21 21 21 21 21 29 41 41 30 21 21 21 21 21 32 44 44 44 44 44 44 33 21 21 21 21 21 21 21 21 21 21 21 21 21 31 31 21 32 44 
44 33 21 21 29 41 41 30 21 21 31 31 21 21 21 29 41 30 32 44 44 44 44 44 44 33 21 21 21 21 21 21 21 21 21 21 29 41 30 21 21 21 32 44 
44 33 21 21 21 31 31 29 41 30 21 21 21 21 21 32 44 33 32 44 44 44 44 44 44 33 21 21 21 21 21 21 21 21 21 21 21 31 21 21 21 21 32 44 
44 33 21 21 21 21 21 21 31 21 21 21 21 21 29 41 43 33 32 44 44 44 44 44 44 33 21 21 21 21 21 21 29 41 41 30 21 21 21 21 21 21 32 44 
44 33 21 21 21 21 21 21 21 21 21 21 21 21 21 31 31 21 32 44 44 44 44 44 44 33 21 21 21 21 21 21 21 31 31 21 21 21 21 21 21 21 32 44 
44 33 21 21 21 21 21 21 21 21 21 29 41 30 21 21 21 21 32 44 44 44 44 44 44 33 21 21 21 21 29 41 30 21 21 29 41 30 21 21 21 21 32 44 
44 33 21 21 21 21 21 21 21 21 21 21 31 21 21 21 21 21 32 44 44 44 44 44 44 33 21 21 21 21 21 31 21 21 21 21 31 21 21 21 21 21 32 44 
44 33 21 21 21 21 21 21 29 41 30 21 21 21 21 21 21 21 32 44 44 44 44 44 44 33 21 29 41 30 21 21 21 21 21 21 21 21 29 41 30 21 32 44 
44 33 21 21 21 21 21 21 21 31 21 21 21 21 21 21 21 21 32 44 44 44 44 44 44 33 21 21 31 21 21 21 21 21 21 21 21 21 21 31 21 21 32 44 
44 33 21 21 21 29 41 30 21 21 21 21 21 21 21 21 21 21 32 44 44 44 44 44 44 33 21 21 21 29 41 30 21 21 21 21 29 41 30 21 21 21 32 44 
44 33 21 21 21 21 31 21 21 21 21 21 21 21 21 21 21 21 21 31 31 31 31 31 31 21 21 21 21 21 31 21 21 21 21 21 21 31 21 21 21 21 32 44 
44 33 29 41 30 21 21 21 21 21 21 21 21 21 21 21 21 21 21 21 21 21 21 21 21 21 21 21 21 21 21 21 29 41 41 30 21 21 21 21 21 21 32 44 
44 33 21 31 21 21 21 21 21 21 21 21 21 21 21 21 21 21 21 21 21 21 21 21 21 21 21 21 21 21 21 21 21 31 31 21 21 21 21 21 21 21 32 44 
42 41 41 41 41 41 41 41 41 41 41 41 41 41 41 41 41 41 41 41 41 41 41 41 41 41 41 41 41 41 41 41 41 41 41 41 41 41 41 41 41 41 41 43 
0 0 0 0 0 0 0 0 0 0 0 0 0 0 0 0 0 0 0 0 0 0 0 0 0 0 0 0 0 0 0 0 0 0 0 0 0 0 0 0 0 0 0 0 
0 0 0 0 0 0 0 0 0 0 0 0 0 0 0 0 0 0 0 0 0 0 0 0 0 0 0 0 0 0 0 0 0 0 0 0 0 0 0 0 0 0 0 0 
0 0 0 0 0 0 0 0 0 0 0 0 0 0 0 0 0 0 0 0 0 0 0 0 0 0 0 0 0 0 0 0 0 0 0 0 0 0 0 0 0 0 0 0