20
18
23 5 0 0 0 0 0 0 0 0 0 0 0 0 0 0 0 0 4 23 
23 5 0 0 0 0 0 0 0 0 0 0 0 0 0 0 0 0 4 23 
23 5 0 0 0 0 0 0 0 0 0 0 0 0 0 0 0 0 4 23 
23 5 10 0 0 0 0 12 0 0 0 0 0 0 0 0 0 0 4 23 
6 22 22 22 22 22 22 22 3 0 0 0 0 0 0 0 0 0 4 23 
23 23 23 23 23 23 23 23 5 0 0 0 0 0 0 0 0 0 4 23 
23 23 23 23 23 23 23 6 22 3 0 0 0 0 0 0 0 0 4 23 
23 23 23 23 23 23 23 23 20 0 0 0 0 0 0 0 0 0 4 23 
23 23 23 23 23 23 23 23 5 0 24 26 0 0 0 0 0 0 4 23 
23 23 23 23 23 23 23 23 5 0 0 0 0 0 12 0 10 0 4 23 
23 23 23 23 23 23 23 23 5 0 0 0 0 2 22 22 22 22 22 7 
23 20 18 18 18 18 18 18 0 0 0 10 0 4 23 23 23 23 23 23 
23 5 0 0 0 0 0 0 0 0 2 22 22 22 7 23 23 23 23 23 
23 5 0 10 0 0 0 0 0 0 4 23 23 23 23 23 23 23 23 23 
6 22 22 22 22 22 22 22 22 22 22 7 23 23 23 23 23 23 23 23
6 22 22 22 22 22 22 22 22 22 22 7 23 23 23 23 23 23 23 23
6 22 22 22 22 22 22 22 22 22 22 7 23 23 23 23 23 23 23 23
6 22 22 22 22 22 22 22 22 22 22 7 23 23 23 23 23 23 23 23
