20
21
44 44 44 44 44 44 44 44 44 44 44 44 44 44 44 44 44 44 44 44 
44 33 21 21 21 21 21 21 21 21 21 21 21 21 21 21 21 21 21 44 
44 21 21 21 21 21 21 21 21 21 21 21 21 21 21 21 21 21 21 44 
44 21 21 21 21 21 21 21 21 21 21 21 21 21 21 21 21 21 21 44 
44 21 21 21 21 21 21 21 21 21 21 21 21 21 21 21 21 21 21 44 
44 21 21 21 21 21 21 21 21 21 21 21 21 21 21 21 21 21 21 44 
44 21 21 21 21 21 21 21 21 21 21 21 21 21 21 21 21 21 21 44 
44 21 21 21 21 21 21 21 21 21 21 21 21 21 21 21 21 21 21 44 
44 21 21 21 21 21 21 21 21 21 21 21 21 21 21 21 21 21 21 44 
44 21 21 21 21 21 21 21 21 21 21 21 21 21 21 21 21 21 21 44 
44 21 21 21 21 21 21 21 21 21 21 21 21 21 21 21 21 21 21 44 
44 21 21 21 21 21 21 21 21 21 21 21 21 21 21 21 21 21 21 44 
44 21 21 21 21 21 21 21 21 21 21 21 21 21 21 21 21 21 21 44 
44 21 21 21 21 21 21 21 21 21 21 21 21 21 21 21 21 21 21 44 
44 21 21 21 21 21 21 21 21 21 21 21 21 21 21 21 21 21 21 44 
44 21 21 21 21 21 21 21 21 21 21 21 21 21 21 21 21 21 21 44 
44 21 21 21 21 21 21 21 21 21 21 21 21 21 21 21 21 21 21 44 
42 41 41 41 41 41 41 41 41 41 41 41 41 41 41 41 41 41 41 43 
0 0 0 0 0 0 0 0 0 0 0 0 0 0 0 0 0 0 0 0 
0 0 0 0 0 0 0 0 0 0 0 0 0 0 0 0 0 0 0 0 
0 0 0 0 0 0 0 0 0 0 0 0 0 0 0 0 0 0 0 0

