120
18
22 5 0 0 0 0 0 0 0 0 0 0 0 0 0 0 0 0 4 22 22 5 0 0 0 0 0 0 0 0 0 0 0 0 0 0 0 0 4 22 22 5 0 0 0 0 0 0 4 22 22 5 0 0 0 0 0 0 4 22 22 5 0 0 0 0 0 0 0 0 0 0 0 0 0 0 0 0 4 22 22 22 22 22 22 22 22 22 22 22 22 22 22 22 22 22 22 22 22 22 22 5 0 0 0 0 0 0 0 0 0 0 0 0 0 0 0 0 4 22 
22 5 0 0 0 0 0 0 0 0 0 0 0 0 0 0 0 0 4 22 22 5 0 0 0 0 0 0 0 0 0 0 0 0 0 0 0 0 4 22 22 5 0 0 0 0 0 0 4 22 22 5 0 0 0 0 0 0 4 22 22 5 0 0 0 0 0 0 0 0 0 0 0 0 0 0 0 0 4 22 22 22 22 22 22 22 22 22 22 22 22 22 22 22 22 22 22 22 22 22 22 5 0 0 0 0 0 0 0 0 0 0 0 0 0 0 0 0 4 22 
22 5 0 0 0 0 0 0 0 0 0 0 0 0 0 0 0 0 4 22 22 5 0 0 0 0 0 0 0 0 0 0 0 0 0 0 0 0 4 22 22 5 0 0 0 0 0 0 4 22 22 5 0 0 0 0 0 0 4 22 22 5 0 0 0 0 0 0 0 0 0 0 0 0 0 0 0 0 4 22 22 22 20 18 18 18 18 18 18 18 18 19 22 22 22 22 22 22 22 22 22 5 0 0 0 0 0 0 0 0 0 0 0 0 0 0 0 0 4 22 
22 5 0 0 0 0 0 0 0 0 0 0 0 0 0 0 0 0 4 22 22 5 0 0 0 0 0 0 0 0 0 0 0 0 0 0 0 0 4 22 22 5 0 0 0 0 0 0 4 22 22 5 0 0 0 0 0 0 4 22 22 5 0 0 0 0 0 0 0 0 0 0 0 0 0 0 0 0 4 22 22 22 5 0 0 0 0 0 0 0 0 4 22 22 22 22 22 22 22 22 22 5 0 0 0 0 0 0 0 0 0 0 0 0 0 0 0 0 4 22 
22 5 0 0 0 0 0 0 0 0 0 0 0 0 0 0 0 0 4 22 22 5 0 0 0 0 0 0 0 0 0 0 0 0 0 0 0 0 4 22 22 5 0 0 0 0 0 0 4 22 22 5 0 0 0 0 0 0 4 22 22 5 0 0 0 0 0 0 0 0 0 0 0 0 0 0 0 0 4 22 22 22 5 0 0 0 0 0 0 0 0 4 22 22 22 22 22 22 22 22 22 5 0 0 0 0 0 0 0 0 0 0 0 0 0 0 0 0 4 22 
22 5 0 0 0 0 0 0 0 0 0 0 0 0 0 0 0 0 4 22 22 5 0 0 0 0 0 0 0 0 0 0 0 0 0 0 0 0 4 22 22 5 0 0 0 0 0 0 4 22 22 5 0 0 0 0 0 0 4 22 22 5 0 0 0 0 0 0 0 0 0 0 0 0 0 0 0 0 4 22 22 22 5 0 0 0 0 0 0 0 0 4 22 22 22 22 22 22 22 22 22 5 0 0 0 0 0 0 0 0 0 0 0 0 0 0 0 0 4 22 
22 5 0 0 0 0 0 0 0 0 0 0 0 0 0 0 0 0 4 22 22 5 0 0 0 0 0 0 0 0 0 0 0 0 0 0 0 0 4 22 22 5 0 0 0 0 0 0 4 22 22 5 0 0 0 0 0 0 4 22 22 5 0 0 0 0 0 0 0 0 0 0 0 0 0 0 0 0 4 22 22 6 21 21 21 21 21 21 3 0 0 4 22 22 22 22 22 22 22 22 22 5 0 0 0 0 0 0 0 0 0 0 0 0 0 0 0 0 4 22 
22 5 0 0 0 0 0 0 0 0 0 0 0 0 0 0 0 0 4 22 22 5 0 0 0 0 0 0 0 0 0 0 0 0 0 0 0 0 4 22 22 5 0 0 0 0 0 0 4 22 22 5 0 0 0 0 0 0 4 22 22 5 0 0 0 0 0 0 0 0 0 0 0 0 0 0 0 0 4 22 22 22 22 22 22 22 22 22 5 0 0 4 22 22 22 22 22 22 22 22 22 5 0 0 0 0 0 0 0 0 0 0 0 0 0 0 0 0 4 22 
22 5 0 0 0 0 0 0 0 0 0 0 0 0 0 0 0 0 4 22 22 5 0 0 0 0 0 0 0 0 0 0 0 0 0 0 0 0 4 22 22 5 0 0 0 0 0 0 4 22 22 5 0 0 0 0 0 0 4 22 22 5 0 0 0 0 0 0 0 0 0 0 0 0 0 0 0 0 4 22 22 22 22 22 22 22 22 22 5 0 0 4 22 22 22 22 22 22 22 22 22 5 0 0 0 0 0 0 0 0 0 0 0 0 0 0 0 0 4 22 
22 5 0 0 0 0 0 0 0 0 0 0 0 0 0 0 0 0 4 22 22 5 0 0 0 0 0 0 0 0 0 0 0 0 0 0 0 0 4 22 22 5 0 0 0 0 0 0 4 22 22 5 0 0 0 0 0 0 4 22 22 5 0 0 0 0 0 0 0 0 0 0 0 0 0 0 0 0 4 22 22 22 22 22 22 22 22 6 21 3 0 4 22 22 22 22 22 22 22 22 22 5 0 0 0 0 0 0 0 0 0 0 0 0 0 0 0 0 4 22 
22 5 0 0 0 0 0 0 0 0 0 0 0 0 0 0 0 0 4 22 22 5 0 0 0 0 0 0 0 0 0 0 0 0 0 0 0 0 4 22 22 5 0 0 0 0 0 0 4 22 22 5 0 0 0 0 0 0 4 22 22 5 0 0 0 0 0 0 0 0 0 0 0 2 21 21 21 21 21 7 22 22 22 22 22 22 22 22 20 0 0 4 22 22 22 22 22 22 22 22 22 5 0 0 0 0 0 0 0 0 0 0 0 0 0 0 0 0 4 22 
22 5 0 0 0 0 0 0 0 0 0 0 0 0 0 0 0 0 4 22 6 21 21 21 21 21 3 0 0 0 0 0 0 0 0 0 0 0 4 22 22 5 0 0 0 0 0 0 4 22 6 21 21 21 3 0 0 0 4 22 22 5 0 0 0 0 0 0 0 0 0 0 0 4 22 22 22 22 22 22 22 20 18 18 18 18 18 18 0 0 0 4 22 22 22 22 22 22 22 22 22 5 0 0 0 0 0 0 0 0 0 0 0 0 0 0 0 0 4 22 
22 5 0 0 0 0 0 0 0 0 0 0 0 2 21 21 21 21 21 7 22 22 22 22 22 22 5 0 0 0 0 0 0 0 0 0 0 0 4 22 22 5 0 0 0 2 21 21 21 7 22 22 22 22 5 0 0 0 4 22 22 5 0 0 0 0 0 0 0 0 0 0 0 4 22 22 22 22 22 22 22 5 0 0 0 0 0 0 0 0 0 4 22 22 22 22 22 22 22 22 22 5 0 0 0 0 0 0 0 0 0 0 0 0 0 0 0 0 4 22 
22 5 0 0 0 0 0 0 0 0 0 0 0 4 22 22 22 22 22 22 22 22 22 22 22 22 5 0 0 0 0 0 0 0 0 0 0 0 4 22 22 5 0 0 0 4 22 22 22 22 22 22 22 22 5 0 0 0 4 22 22 5 0 0 0 0 0 0 0 0 0 0 0 4 22 22 22 22 22 22 22 5 0 0 0 0 0 0 0 0 0 4 22 22 22 22 22 22 22 22 22 5 0 0 0 0 0 0 0 0 0 0 0 0 0 0 0 0 4 22 
6 21 21 21 21 21 21 21 21 21 21 21 21 21 7 22 22 22 22 22 22 22 22 22 22 6 21 21 21 21 21 21 21 21 21 21 21 21 21 7 6 21 21 21 21 21 7 22 22 22 22 22 22 6 21 21 21 21 21 7 6 21 21 21 21 21 21 21 21 21 21 21 21 21 7 22 22 22 22 22 6 21 21 21 21 21 21 21 21 21 21 21 7 22 22 22 22 22 22 22 6 21 21 21 21 21 21 21 3 0 0 0 2 21 21 21 21 21 21 7 
0 0 0 0 0 0 0 0 0 0 0 0 0 0 0 0 0 0 0 0 0 0 0 0 0 0 0 0 0 0 0 0 0 0 0 0 0 0 0 0 0 0 0 0 0 0 0 0 0 0 0 0 0 0 0 0 0 0 0 0 0 0 0 0 0 0 0 0 0 0 0 0 0 0 0 0 0 0 0 0 0 0 0 0 0 0 0 0 0 0 0 0 0 0 0 0 0 0 0 0 0 0 0 0 0 0 0 0 0 0 0 0 0 0 0 0 0 0 0 0 
0 0 0 0 0 0 0 0 0 0 0 0 0 0 0 0 0 0 0 0 0 0 0 0 0 0 0 0 0 0 0 0 0 0 0 0 0 0 0 0 0 0 0 0 0 0 0 0 0 0 0 0 0 0 0 0 0 0 0 0 0 0 0 0 0 0 0 0 0 0 0 0 0 0 0 0 0 0 0 0 0 0 0 0 0 0 0 0 0 0 0 0 0 0 0 0 0 0 0 0 0 0 0 0 0 0 0 0 0 0 0 0 0 0 0 0 0 0 0 0 
0 0 0 0 0 0 0 0 0 0 0 0 0 0 0 0 0 0 0 0 0 0 0 0 0 0 0 0 0 0 0 0 0 0 0 0 0 0 0 0 0 0 0 0 0 0 0 0 0 0 0 0 0 0 0 0 0 0 0 0 0 0 0 0 0 0 0 0 0 0 0 0 0 0 0 0 0 0 0 0 0 0 0 0 0 0 0 0 0 0 0 0 0 0 0 0 0 0 0 0 0 0 0 0 0 0 0 0 0 0 0 0 0 0 0 0 0 0 0 0

